-----------------------------------------
-                                       -
-                                    ----
----                    -------         -
-         --        --                  -
-            --                         -
-               --       *            ---
-                                       -
---                 ----                -
-                            *          -
-                           ---         -
-    ---                                -
-                ---                --- -
-                                       -
-                                       -
-                               ----    -
-                                       -
-   --------                            -
-          *                            -
-        ----                           -
-                  *      ---          --
-                 P                     -
-   *         --------                  -
------                          ---     -
-                                       -
-                   **               ----
-          ---------                    -
-                        ---            -
-                                       -
-----------------------------------------